{
  "name" : "Pacman!",
  "height" : 31,
  "width" : 56,
  "tilemap" :
  {
    "file" : "pacman.png",
    "tile" :
    {
      "height" : 32,
      "width" : 32
    }
  },
  "map" :
  [
    [ 0, 1, 1, 1, 1, 1, 1, 1, 1, 1, 1, 1, 1, 5, 0, 1, 1, 1, 1, 1, 1, 1, 1, 1, 1, 1, 1, 5, 0, 1, 1, 1, 1, 1, 1, 1, 1, 1, 1, 1, 1, 5, 0, 1, 1, 1, 1, 1, 1, 1, 1, 1, 1, 1, 1, 5],
    [ 8, 9, 9, 9, 9, 9, 9, 9, 9, 9, 9, 9, 9, 10, 12, 9, 9, 9, 9, 9, 9, 9, 9, 9, 9, 9, 9, 13, 8, 9, 9, 9, 9, 9, 9, 9, 9, 9, 9, 9, 9, 10, 12, 9, 9, 9, 9, 9, 9, 9, 9, 9, 9, 9, 9, 13],
    [ 8, 9, 20, 17, 17, 18, 9, 20, 17, 17, 17, 18, 9, 10, 12, 9, 20, 17, 17, 17, 18, 9, 20, 17, 17, 18, 9, 13, 8, 9, 20, 17, 17, 18, 9, 20, 17, 17, 17, 18, 9, 10, 12, 9, 20, 17, 17, 17, 18, 9, 20, 17, 17, 18, 9, 13],
    [ 8, 9, 10, 9, 9, 12, 9, 10, 9, 9, 9, 12, 9, 10, 12, 9, 10, 9, 9, 9, 12, 9, 10, 9, 9, 12, 9, 13, 8, 9, 10, 9, 9, 12, 9, 10, 9, 9, 9, 12, 9, 10, 12, 9, 10, 9, 9, 9, 12, 9, 10, 9, 9, 12, 9, 13],
    [ 8, 9, 36, 33, 33, 34, 9, 36, 33, 33, 33, 34, 9, 36, 34, 9, 36, 33, 33, 33, 34, 9, 36, 33, 33, 34, 9, 13, 8, 9, 36, 33, 33, 34, 9, 36, 33, 33, 33, 34, 9, 36, 34, 9, 36, 33, 33, 33, 34, 9, 36, 33, 33, 34, 9, 13],
    [ 8, 9, 9, 9, 9, 9, 9, 9, 9, 9, 9, 9, 9, 9, 9, 9, 9, 9, 9, 9, 9, 9, 9, 9, 9, 9, 9, 13, 8, 9, 9, 9, 9, 9, 9, 9, 9, 9, 9, 9, 9, 9, 9, 9, 9, 9, 9, 9, 9, 9, 9, 9, 9, 9, 9, 13],
    [ 8, 9, 20, 17, 17, 18, 9, 20, 18, 9, 20, 17, 17, 17, 17, 17, 17, 18, 9, 20, 18, 9, 20, 17, 17, 18, 9, 13, 8, 9, 20, 17, 17, 18, 9, 20, 18, 9, 20, 17, 17, 17, 17, 17, 17, 18, 9, 20, 18, 9, 20, 17, 17, 18, 9, 13],
    [ 8, 9, 36, 33, 33, 34, 9, 10, 12, 9, 36, 33, 33, 7, 6, 33, 33, 34, 9, 10, 12, 9, 36, 33, 33, 34, 9, 13, 8, 9, 36, 33, 33, 34, 9, 10, 12, 9, 36, 33, 33, 7, 6, 33, 33, 34, 9, 10, 12, 9, 36, 33, 33, 34, 9, 13],
    [ 8, 9, 9, 9, 9, 9, 9, 10, 12, 9, 9, 9, 9, 10, 12, 9, 9, 9, 9, 10, 12, 9, 9, 9, 9, 9, 9, 13, 8, 9, 9, 9, 9, 9, 9, 10, 12, 9, 9, 9, 9, 10, 12, 9, 9, 9, 9, 10, 12, 9, 9, 9, 9, 9, 9, 13],
    [ 40, 41, 41, 41, 41, 23, 9, 10, 14, 17, 17, 18, 9, 10, 12, 9, 20, 17, 17, 15, 12, 9, 22, 41, 41, 41, 41, 45, 40, 41, 41, 41, 41, 23, 9, 10, 14, 17, 17, 18, 9, 10, 12, 9, 20, 17, 17, 15, 12, 9, 22, 41, 41, 41, 41, 45],
    [ -1, -1, -1, -1, -1, 8, 9, 10, 6, 33, 33, 34, 9, 36, 34, 9, 36, 33, 33, 7, 12, 9, 13, -1, -1, -1, -1, -1, -1, -1, -1, -1, -1, 8, 9, 10, 6, 33, 33, 34, 9, 36, 34, 9, 36, 33, 33, 7, 12, 9, 13, -1, -1, -1, -1, -1],
    [ -1, -1, -1, -1, -1, 8, 9, 10, 12, 9, 9, 9, 9, 9, 9, 9, 9, 9, 9, 10, 12, 9, 13, -1, -1, -1, -1, -1, -1, -1, -1, -1, -1, 8, 9, 10, 12, 9, 9, 9, 9, 9, 9, 9, 9, 9, 9, 10, 12, 9, 13, -1, -1, -1, -1, -1],
    [ -1, -1, -1, -1, -1, 8, 9, 10, 12, 9, 22, 41, 41, 41, 41, 41, 41, 23, 9, 10, 12, 9, 13, -1, -1, -1, -1, -1, -1, -1, -1, -1, -1, 8, 9, 10, 12, 9, 22, 41, 41, 41, 41, 41, 41, 23, 9, 10, 12, 9, 13, -1, -1, -1, -1, -1],
    [ 1, 1, 1, 1, 1, 31, 9, 36, 34, 9, 13, -1, -1, -1, -1, -1, -1, 8, 9, 36, 34, 9, 30, 1, 1, 1, 1, 1, 1, 1, 1, 1, 1, 31, 9, 36, 34, 9, 13, -1, -1, -1, -1, -1, -1, 8, 9, 36, 34, 9, 30, 1, 1, 1, 1, 1],
    [ -1, -1, -1, -1, -1, -1, 9, 9, 9, 9, 13, -1, -1, -1, -1, -1, -1, 8, 9, 9, 9, 9, 9, 9, 9, 9, 9, 9, 9, 9, 9, 9, 9, 9, 9, 9, 9, 9, 13, -1, -1, -1, -1, -1, -1, 8, 9, 9, 9, 9, -1, -1, -1, -1, -1, -1],
    [ 41, 41, 41, 41, 41, 23, 9, 20, 18, 9, 13, -1, -1, -1, -1, -1, -1, 8, 9, 20, 18, 9, 22, 41, 41, 41, 41, 41, 41, 41, 41, 41, 41, 23, 9, 20, 18, 9, 13, -1, -1, -1, -1, -1, -1, 8, 9, 20, 18, 9, 22, 41, 41, 41, 41, 41],
    [ -1, -1, -1, -1, -1, 8, 9, 10, 12, 9, 30, 1, 1, 1, 1, 1, 1, 31, 9, 10, 12, 9, 13, -1, -1, -1, -1, -1, -1, -1, -1, -1, -1, 8, 9, 10, 12, 9, 30, 1, 1, 1, 1, 1, 1, 31, 9, 10, 12, 9, 13, -1, -1, -1, -1, -1],
    [ -1, -1, -1, -1, -1, 8, 9, 10, 12, 9, 9, 9, 9, 9, 9, 9, 9, 9, 9, 10, 12, 9, 13, -1, -1, -1, -1, -1, -1, -1, -1, -1, -1, 8, 9, 10, 12, 9, 9, 9, 9, 9, 9, 9, 9, 9, 9, 10, 12, 9, 13, -1, -1, -1, -1, -1],
    [ -1, -1, -1, -1, -1, 8, 9, 10, 12, 9, 20, 17, 17, 17, 17, 17, 17, 18, 9, 10, 12, 9, 13, -1, -1, -1, -1, -1, -1, -1, -1, -1, -1, 8, 9, 10, 12, 9, 20, 17, 17, 17, 17, 17, 17, 18, 9, 10, 12, 9, 13, -1, -1, -1, -1, -1],
    [ 0, 1, 1, 1, 1, 31, 9, 36, 34, 9, 36, 33, 33, 7, 6, 33, 33, 34, 9, 36, 34, 9, 30, 1, 1, 1, 1, 5, 0, 1, 1, 1, 1, 31, 9, 36, 34, 9, 36, 33, 33, 7, 6, 33, 33, 34, 9, 36, 34, 9, 30, 1, 1, 1, 1, 5],
    [ 8, 9, 9, 9, 9, 9, 9, 9, 9, 9, 9, 9, 9, 10, 12, 9, 9, 9, 9, 9, 9, 9, 9, 9, 9, 9, 9, 13, 8, 9, 9, 9, 9, 9, 9, 9, 9, 9, 9, 9, 9, 10, 12, 9, 9, 9, 9, 9, 9, 9, 9, 9, 9, 9, 9, 13],
    [ 8, 9, 20, 17, 17, 18, 9, 20, 17, 17, 17, 18, 9, 10, 12, 9, 20, 17, 17, 17, 18, 9, 20, 17, 17, 18, 9, 13, 8, 9, 20, 17, 17, 18, 9, 20, 17, 17, 17, 18, 9, 10, 12, 9, 20, 17, 17, 17, 18, 9, 20, 17, 17, 18, 9, 13],
    [ 8, 9, 36, 33, 7, 12, 9, 36, 33, 33, 33, 34, 9, 36, 34, 9, 36, 33, 33, 33, 34, 9, 10, 6, 33, 34, 9, 13, 8, 9, 36, 33, 7, 12, 9, 36, 33, 33, 33, 34, 9, 36, 34, 9, 36, 33, 33, 33, 34, 9, 10, 6, 33, 34, 9, 13],
    [ 8, 9, 9, 9, 10, 12, 9, 9, 9, 9, 9, 9, 9, 9, 9, 9, 9, 9, 9, 9, 9, 9, 10, 12, 9, 9, 9, 13, 8, 9, 9, 9, 10, 12, 9, 9, 9, 9, 9, 9, 9, 9, 9, 9, 9, 9, 9, 9, 9, 9, 10, 12, 9, 9, 9, 13],
    [ 40, 17, 18, 9, 10, 12, 9, 20, 18, 9, 20, 17, 17, 17, 17, 17, 17, 18, 9, 20, 18, 9, 10, 12, 9, 20, 17, 45, 40, 17, 18, 9, 10, 12, 9, 20, 18, 9, 20, 17, 17, 17, 17, 17, 17, 18, 9, 20, 18, 9, 10, 12, 9, 20, 17, 45],
    [ 0, 33, 34, 9, 36, 34, 9, 10, 12, 9, 36, 33, 33, 7, 6, 33, 33, 34, 9, 10, 12, 9, 36, 34, 9, 36, 33, 5, 0, 33, 34, 9, 36, 34, 9, 10, 12, 9, 36, 33, 33, 7, 6, 33, 33, 34, 9, 10, 12, 9, 36, 34, 9, 36, 33, 5],
    [ 8, 9, 9, 9, 9, 9, 9, 10, 12, 9, 9, 9, 9, 10, 12, 9, 9, 9, 9, 10, 12, 9, 9, 9, 9, 9, 9, 13, 8, 9, 9, 9, 9, 9, 9, 10, 12, 9, 9, 9, 9, 10, 12, 9, 9, 9, 9, 10, 12, 9, 9, 9, 9, 9, 9, 13],
    [ 8, 9, 20, 17, 17, 17, 17, 15, 14, 17, 17, 18, 9, 10, 12, 9, 20, 17, 17, 15, 14, 17, 17, 17, 17, 18, 9, 13, 8, 9, 20, 17, 17, 17, 17, 15, 14, 17, 17, 18, 9, 10, 12, 9, 20, 17, 17, 15, 14, 17, 17, 17, 17, 18, 9, 13],
    [ 8, 9, 36, 33, 33, 33, 33, 33, 33, 33, 33, 34, 9, 36, 34, 9, 36, 33, 33, 33, 33, 33, 33, 33, 33, 34, 9, 13, 8, 9, 36, 33, 33, 33, 33, 33, 33, 33, 33, 34, 9, 36, 34, 9, 36, 33, 33, 33, 33, 33, 33, 33, 33, 34, 9, 13],
    [ 8, 9, 9, 9, 9, 9, 9, 9, 9, 9, 9, 9, 9, 9, 9, 9, 9, 9, 9, 9, 9, 9, 9, 9, 9, 9, 9, 13, 8, 9, 9, 9, 9, 9, 9, 9, 9, 9, 9, 9, 9, 9, 9, 9, 9, 9, 9, 9, 9, 9, 9, 9, 9, 9, 9, 13],
    [ 40, 41, 41, 41, 41, 41, 41, 41, 41, 41, 41, 41, 41, 41, 41, 41, 41, 41, 41, 41, 41, 41, 41, 41, 41, 41, 41, 45, 40, 41, 41, 41, 41, 41, 41, 41, 41, 41, 41, 41, 41, 41, 41, 41, 41, 41, 41, 41, 41, 41, 41, 41, 41, 41, 41, 45]
  ]


}